###                 #########
#   ###################   # #
#   ##                # # # #
# # ## ### ## ######### # # #
# #    #   ##B#         # # #
# # ## ################ # # #
### ##             #### # # #
###             ##    # # # #
###### ####             #   #
A      ######################