####B     #
# ###  ## #
## #   # ##
#A    # ## 
##   ##    